1111111111
0000000000
0000000000
0000000000
2222222222
0000000000
0000000000
1111111111
